NO                   ./pics/q.png

SO      ./pics/qq.png

WE      ./pics/qqq.png

C       255,255,1

EA      ./pics/qqqq.png

F       124,99,2

1111111111111111111111111
100N000000000000000000001
1011000000000000000000001
1111111111111111111111111