NO ./pics/q.png

SO ./pics/qq.png

C  255,255,255

F   0,2,1

WE ./pics/qqq.png

EA ./pics/qqqq.png

11111111111111111
10N00000000000001
10000000000000001
10000010000000001
10000001000000001
10000000100000001
11111111111111111