NO ./pics/q.png

SO ./pics/qq.png

WE ./pics/qqq.png

C     0,119,255

EA ./pics/qqqq.png

F 11,255,12

1111111111111111111111111
101D100000011111100000001
100000000001    1001D1001      
10001D1000111111100000001
10001010000000000000N0001
1111111111111111111111111